8000 8000 8000 8000 8000 8000 8000 8000 8000 8000 8000 8000 8000 8000 8000 8000 8000 8000 8000 8000 8000 8000 8000 8000
8000 8000 8000 8000 8000 8000 8000 8000 8000 8000 8000 8000 8000 8000 8000 8000 8000 8000 8000 8000 8000 8000 8000 8000
8000 8000 8000 8000 8000 8000 8000 8000 8000 8000 8000 8000 8000 8000 8000 8000 8000 8000 8000 8000 8000 8000 8000 8000
8000 8000 8000 8000 8000 8000 8000 8000 8000 8000 0000 0000 0000 0000 0000 8000 8000 8000 8000 8000 8000 8000 8000 8000
8000 8000 8000 8000 8000 8000 8000 8000 8000 0000 0000 8000 8000 8000 0000 8000 8000 8000 8000 8000 8000 8000 8000 8000
8000 8000 8000 8000 8000 8000 8000 8000 8000 8000 0000 8000 8000 8000 0000 8000 8000 8000 8000 8000 8000 8000 8000 8000
8000 8000 8000 8000 8000 8000 8000 8000 8000 0000 0000 8000 0000 0000 0000 8000 8000 8000 8000 8000 8000 8000 8000 8000
8000 8000 8000 8000 8000 8000 8000 8000 8000 8000 0000 8000 0000 0000 0000 8000 8000 8000 8000 8000 8000 8000 8000 8000
8000 8000 8000 8000 8000 8000 8000 8000 8000 8000 8000 8000 8000 8000 8000 8000 8000 8000 8000 8000 8000 8000 8000 8000
8000 8000 8000 8000 8000 8000 8000 8000 8000 8000 8000 8000 8000 8000 8000 8000 8000 8000 8000 8000 8000 8000 8000 8000
8000 8000 8000 8000 8000 8000 8000 8000 8000 8000 8000 8000 8000 8000 8000 8000 8000 8000 8000 8000 8000 8000 8000 8000
8000 8000 8000 8000 8000 8000 8000 8000 8000 8000 8000 8000 8000 8000 8000 8000 8000 8000 8000 8000 8000 8000 8000 8000
8000 8000 8000 8000 8000 8000 8000 8000 8000 8000 8000 8000 8000 0000 8000 0000 8000 8000 8000 8000 8000 8000 8000 8000
8000 8000 8000 0000 0000 0000 0000 8000 8000 8000 0000 8000 8000 8000 8000 0000 8000 8000 0000 8000 8000 8000 8000 8000
8000 8000 8000 8000 8000 8000 8000 8000 0000 0000 0000 0000 0000 0000 8000 0000 8000 8000 8000 8000 8000 8000 8000 8000
8000 8000 8000 8000 8000 8000 8000 8000 0000 8000 8000 8000 8000 8000 8000 0000 0000 8000 8000 8000 8000 8000 8000 8000
8000 8000 8000 8000 8000 0000 8000 8000 0000 8000 0000 8000 0000 8000 8000 0000 8000 8000 8000 8000 8000 8000 8000 8000
8000 8000 8000 8000 8000 0000 8000 8000 8000 8000 8000 8000 0000 8000 8000 8000 8000 8000 8000 8000 8000 8000 8000 8000
8000 8000 8000 8000 8000 0000 8000 8000 0000 0000 0000 0000 0000 8000 0000 0000 0000 0000 0000 8000 8000 8000 8000 8000
8000 8000 8000 8000 8000 0000 8000 8000 8000 8000 0000 8000 8000 8000 8000 8000 8000 8000 8000 8000 8000 8000 8000 8000
8000 8000 8000 8000 8000 0000 8000 8000 8000 8000 0000 8000 8000 8000 0000 8000 8000 8000 8000 8000 8000 8000 8000 8000
8000 8000 8000 8000 8000 8000 8000 8000 8000 8000 8000 8000 8000 8000 8000 0000 0000 8000 8000 8000 8000 8000 8000 8000
8000 8000 8000 0000 8000 8000 8000 8000 8000 8000 8000 8000 8000 8000 8000 0000 0000 8000 8000 8000 8000 8000 8000 8000
8000 8000 0000 0000 8000 8000 8000 8000 8000 8000 8000 8000 8000 8000 8000 0000 0000 8000 8000 8000 8000 8000 8000 8000
8000 0000 0000 0000 0000 8000 8000 8000 8000 8000 8000 8000 8000 8000 8000 8000 8000 8000 8000 8000 8000 8000 8000 8000
8000 8000 8000 8000 8000 8000 8000 8000 8000 8000 8000 8000 8000 8000 8000 8000 8000 8000 8000 8000 8000 8000 8000 8000
8000 8000 8000 0000 8000 8000 8000 8000 8000 8000 8000 8000 8000 8000 8000 8000 8000 8000 8000 8000 8000 8000 8000 8000
8000 8000 0000 0000 8000 8000 8000 8000 8000 8000 8000 8000 8000 8000 8000 8000 8000 8000 8000 8000 8000 8000 8000 8000
8000 0000 0000 0000 0000 8000 8000 8000 8000 8000 8000 8000 8000 8000 8000 8000 8000 8000 8000 8000 8000 8000 8000 8000
8000 8000 8000 8000 8000 8000 8000 8000 8000 8000 8000 8000 8000 8000 8000 8000 8000 8000 8000 8000 8000 8000 8000 8000
8000 8000 8000 8000 8000 8000 8000 8000 8000 8000 8000 8000 8000 8000 8000 8000 8000 8000 8000 8000 8000 8000 8000 8000
8000 8000 8000 8000 8000 8000 0000 8000 0000 8000 8000 8000 8000 8000 8000 8000 8000 8000 8000 8000 8000 8000 8000 8000
8000 8000 8000 0000 8000 8000 0000 8000 0000 8000 8000 0000 8000 8000 8000 8000 8000 8000 8000 8000 8000 8000 8000 8000
8000 8000 0000 8000 8000 0000 0000 8000 0000 0000 8000 8000 0000 8000 8000 8000 8000 8000 8000 8000 8000 8000 8000 8000
8000 8000 8000 8000 0000 0000 8000 8000 8000 0000 0000 8000 8000 8000 8000 8000 8000 8000 8000 8000 8000 8000 8000 8000
8000 8000 8000 0000 0000 8000 8000 8000 8000 8000 0000 0000 8000 8000 8000 8000 8000 8000 8000 8000 8000 8000 8000 8000
8000 0000 0000 0000 8000 8000 0000 8000 0000 8000 8000 0000 0000 0000 8000 8000 8000 8000 8000 8000 8000 8000 8000 8000
8000 8000 8000 8000 8000 8000 8000 8000 8000 8000 8000 8000 8000 8000 8000 8000 8000 8000 8000 8000 8000 8000 8000 8000
8000 0000 0000 0000 8000 8000 0000 8000 0000 8000 8000 0000 0000 0000 8000 8000 8000 8000 8000 8000 8000 8000 8000 8000
8000 8000 8000 0000 0000 8000 8000 8000 8000 8000 0000 0000 8000 8000 8000 8000 8000 8000 8000 8000 8000 8000 8000 8000
8000 8000 8000 8000 0000 0000 8000 8000 8000 0000 0000 8000 8000 8000 8000 8000 8000 8000 8000 8000 8000 8000 8000 8000
8000 8000 0000 8000 8000 0000 0000 8000 0000 0000 8000 8000 0000 8000 8000 8000 8000 8000 8000 8000 8000 8000 8000 8000
8000 8000 8000 0000 8000 8000 0000 8000 0000 8000 8000 0000 8000 8000 8000 8000 8000 8000 8000 8000 8000 8000 8000 8000
8000 8000 8000 8000 8000 8000 0000 8000 0000 8000 8000 8000 8000 8000 8000 8000 8000 8000 8000 8000 8000 8000 8000 8000
8000 8000 8000 8000 8000 8000 8000 8000 8000 8000 8000 8000 8000 8000 8000 8000 8000 8120 8100 8000 8000 8000 8000 8000
8000 8000 8000 8000 8000 8000 8000 8000 8000 8000 8000 8000 8000 8000 8000 8120 80A0 8020 8020 8100 8000 8000 8000 8000
8000 8000 8000 8000 8000 8000 81E0 81C0 8000 8000 8000 8000 8000 8000 8120 8020 8020 8020 8020 8080 8000 8000 8000 8000
8100 8000 8000 8000 00C0 0020 00A0 81A0 8000 8000 8000 8000 8000 8000 80C0 8020 8020 8020 8020 80E0 8000 8000 8000 8000
8020 8100 8000 8000 8000 8000 8200 8180 8000 8000 8000 8000 8000 8000 8000 80C0 8020 8020 80E0 8000 8000 8000 8000 8000
8020 8020 8100 8000 8000 8000 8000 8000 8000 8000 8000 8000 8000 8000 8000 8000 80C0 80E0 8000 8000 8000 8000 8000 8000
8020 8020 80E0 8000 8000 8000 8000 8000 8000 8000 8000 81E0 81C0 8000 8000 8000 8000 8000 8000 8000 8000 8000 8000 8000
8020 80E0 8000 8000 8000 8000 00C0 0020 0020 0020 0020 00A0 81A0 8000 8000 8000 8000 8000 8000 8000 8000 8000 8000 8000
8080 8000 8000 8000 8000 8000 8000 8000 8000 8000 8000 8200 8180 8000 8000 8000 8000 8000 8000 8000 8000 8000 8000 8000
80E0 8000 8000 8000 8000 8000 8000 8000 8000 8000 8000 8000 8000 8000 8000 8000 8000 8000 8000 8000 8000 8000 8000 8000
8000 8000 8000 8000 81E0 81C0 8000 8000 8000 8000 8000 8000 8000 8000 81E0 8160 81C0 8000 8000 8000 8000 8000 8000 8000
8000 8000 0060 0080 8160 8160 81C0 81E0 81C0 8000 8000 8000 8000 81E0 8160 8160 8160 81C0 8000 8000 8000 8000 8000 8000
8000 0060 0060 0080 8160 8160 8160 8160 8160 81C0 8000 8000 81E0 8160 8160 8160 8160 81A0 8000 8000 8000 8000 8000 8000
0060 0060 0060 0080 8160 8160 8160 8160 8160 8160 81C0 81E0 8160 8160 8160 8160 8160 81A0 8000 8000 8000 8000 8000 8000
0060 0060 0060 0080 8160 0040 0020 0020 00A0 8160 8160 0040 0020 0020 00A0 8160 8160 8180 8000 8000 8000 8000 8000 8000
0060 0060 0060 0080 8160 8160 8160 8160 8160 8160 8160 8160 8160 8160 8160 8160 81A0 8000 8000 8000 8000 8000 8000 8000
0060 0060 0060 0080 8160 8160 8160 8160 8160 8160 8160 8160 8160 8160 8160 8160 81A0 8000 8000 8000 8000 8000 8000 8000
0060 0060 0060 0080 8160 8160 8160 8160 8160 8160 8160 8160 8160 8160 8160 8160 81A0 8000 8000 8000 8000 8000 8000 8000
0060 0060 0060 0080 8160 0040 0020 0020 00A0 8160 8160 8160 8160 0040 00A0 8160 8160 81C0 8000 8000 8000 8000 8000 8000
0060 0060 0060 0080 8160 8160 8160 8160 8160 8160 8160 8160 8160 8160 8160 8160 8160 81A0 8000 8000 8000 8000 8000 8000
0060 0060 0060 0080 8160 8160 8160 8160 8160 8160 8160 8160 8160 8160 8160 8160 8160 8160 81C0 8000 8000 8000 8000 8000
0060 0060 0060 0080 8160 8160 8160 8160 8160 8160 8160 8160 8160 8160 8160 8160 8160 8160 81A0 8000 8000 8000 8000 8000
0060 0060 0060 0080 8160 8160 0040 0020 00A0 8160 8160 0040 0020 0020 00A0 8160 8160 8160 81A0 8000 8000 8000 8000 8000
0060 0060 0060 0080 8160 8160 8160 8160 8160 8160 8160 8160 8160 8160 8160 8160 8160 8160 8160 81C0 8000 8000 8000 8000
