8000 8000 8000 8000 8000 8000 8000 8000
8000 8000 0000 0000 0000 0000 0000 8000
8000 0000 0000 8000 8000 8000 0000 8000
8000 8000 0000 8000 8000 8000 0000 8000
8000 0000 0000 8000 0000 0000 0000 8000
8000 8000 0000 8000 0000 0000 0000 8000
8000 8000 8000 8000 8000 8000 8000 8000